                                                                                                             +-----+                                           
+--------------------+                                                                                       |.....############################################
|....................|                                                                                       |.....|          #                               #
|....................|                                                                                       |.....|          #                               #
|....................#####                                                                                   |.....|          #                               #
+-------+.....+------++--#--------+   +----+     +------+  +---+   +--------+       +---------+        +-----+.....|   +------#----+      +-------+           #
        |.....|       |...........|   |....+-----+......|  |...+---+........|    +--+.........++    +--+...........|   |...........|   +--+.......++          #
        |.....|     +-+...........+-+ |.................| ++................|  +-+..+-----+....++ +-+..............| +-+..+-----+..+-+ ++.......+--+-##########
        |.....|     |....+-----+....| |.....+-----+.....| |.....+-----+.....|+-+....|     |....++ |.....+----+.....| |....|     |....###+...+---+  +-+        #
        |.....|     |....|     |....| |.....|     |.....###.....|     |.....||......+-----+....++ |.....|    |.....###....|     |....|  +---+      +-+        #
        |.....|     |....|     |....###.....|     +-----+ |.....|     |.....||............+--######.....|    |.....| |....|     |....|     +-+-+              #
        |.....#######....|     |....| |.....|             |.....|     |.....||.......+------+     |.....|    |.....| |....|     |....|       +.+---+          #
        |.....|     |....|     |....| |.....|             |.....|     |.....##.......|            |.....|    |.....| |....|     |....| +-+    +....+          #
        |.....|     |....+-----+....| |.....|             |.....+-----+.....|+-+.....+-+          |.....+----+.....| |....+-----+....| +.+----+....+-+        #
        |.....|     |...............| |.....|             |.................|  ++......+------+   |................| |...............| |...........+..++      #
        +--#--+     +-+...........+-+ |.....|        ######...............+-+   ++............|   ++.....+--+......| +-|...........+-+ +-+......+----+        #
           #          +-----------+   +-----+             |......+--------+      +-------#----+    +-----+  +---#--+   +-------#---+     +---#--+             #
           #                                              |......|                       #                      #              #             #                #
           #                                              |......|                       #                      #              #             #                #
           #                                              |......|                       #                      #              #             #                #
           #                                              |......|                       #                      #              #             #                #
           #                                              +-#----+                       #                      #              #             #                #
     ##########################################################################################################################################################
